Arkanoid|Arkanoid - Doh It Again
Brawl Brothers - Rival Turf! 2|Brawl Brothers
Chavez|Riddick Bowe Boxing
Chavez II|Boxing Legends of the Ring
Dennis|Dennis the Menace
Dino City|DinoCity
Eric Cantona Football Challenge|Striker
Eye of the Beholder|Advanced Dungeons & Dragons - Eye of the Beholder
FIFA 97|FIFA Soccer 97
Garry Kitchen's Super Battletank|Garry Kitchen's Super Battletank - War in the Gulf
Hagane|Hagane - The Final Conflict
J.R.R. Tolkien's The Lord of the Rings - Volume One|J.R.R. Tolkien's The Lord of the Rings - Volume 1
Lamborghini - American Challenge|Lamborghini American Challenge
Looney Tunes - Road Runner|Road Runner's Death Valley Rally
Lothar Matthaeus Super Soccer|Manchester United Championship Soccer
Mario's Super Picross|Mario no Super Picross
Mega Man & Bass|Rockman & Forte
Mickey Mania|Mickey Mania - The Timeless Adventures of Mickey Mouse
NHL Hockey '94|NHL '94
Ninjawarriors - The New Generation|Ninjawarriors
Nintendo Scope 6|Super Scope 6
Pierre le Chef Is... Out to Lunch|Out To Lunch
Power Rangers|Mighty Morphin Power Rangers
Puzzle Bobble|Bust-A-Move
Puzzle Bobble - Bust-A-Move|Bust-A-Move
R.P.M. Racing|Radical Psycho Machine Racing
Rival Turf|Rival Turf!
Speed Racer in My Most Dangerous Adventures|Speed Racer
Soccer Shootout|Capcom's Soccer Shootout
Super James Pond II|Super James Pond
Time Slip|Timeslip
Trials of Mana|Seiken Densetsu 3
Wolfenstein 3-D|Wolfenstein 3D
World Soccer|Striker